DEEEEWWWWW
EEEEWWWWEE
EEEWWWEWEW
EEWWEEWWWW
EEWWWWWWWW
EWWWWWWWEE
EEEEWWEWEE
EEEWWEWEEE
EEEEEEWEEE
EEEEEEEEEA
