DEEEWEEEE
EEEEWEEEE
EEEWWEEEE
WWWWWWEEE
WWWWWWWWW
EEEWWEEEE
EEEEWEEEE
EEEWWEEEE
EEEWWEEEA
