DEWEEEEEW
EWEEEWWWE
EWWWWEEWE
EWWWWWWEE
EWEWWEWEE
WEEWWWEEE
EWWWWWWEE
EEWWEWEEE
EEEEWWEEA
