AEEEEWEEE
EEEEEWEWE
EWEEEWEWE
WEEWWEWED
EWEEEEEWE
WEEWEEEWE
EWWWWWWEW
EEWWEWEEE
EEEEWWEEE
