DEEEEEEEE
EEEEWWEEE
EEEWWEWEE
EEWEEEWEE
EWWEEEEWE
WEEWEEEWE
EWWWWWWEE
EEWWEWEEE
EEEEWWEEA
